[CLS] το Nissan GT - R παρά ##γεται από το [MASK] [MASK] . [SEP]	Nissan Nissan	Nissan
[CLS] το Ferrari Enzo Ferrari παρά ##γεται από το [MASK] [MASK] [MASK] . [SEP]	Ferrari Enzo Ferrari	Ferrari
[CLS] το Fiat 126 παρά ##γεται από το [MASK] [MASK] . [SEP]	Fiat Fiat	Ό ##μ ##ιλ ##ος Fiat
[CLS] το Windows 2000 παρά ##γεται από το [MASK] . [SEP]	Microsoft	Microsoft
[CLS] το Toyota Su ##pra παρά ##γεται από το [MASK] . [SEP]	Toyota	Toyota
[CLS] το Fiat Tipo παρά ##γεται από το [MASK] [MASK] . [SEP]	Fiat Tipo	Ό ##μ ##ιλ ##ος Fiat
[CLS] το Airbus A3 ##30 παρά ##γεται από το [MASK] . [SEP]	Airbus	Airbus
[CLS] το Windows Server 2003 παρά ##γεται από το [MASK] . [SEP]	Microsoft	Microsoft
[CLS] το Audi 80 παρά ##γεται από το [MASK] . [SEP]	Audi	Audi
[CLS] το BMW F ##01 παρά ##γεται από το [MASK] . [SEP]	BMW	BMW
[CLS] το Douglas DC - 1 παρά ##γεται από το [MASK] [MASK] [MASK] [MASK] . [SEP]	Douglas DC - 1	Douglas Aircraft Company
[CLS] το Renault Sa ##fra ##ne παρά ##γεται από το [MASK] [MASK] . [SEP]	Renault Renault	Renault
[CLS] το Fiat Cinq ##ue ##cento παρά ##γεται από το [MASK] [MASK] [MASK] [MASK] . [SEP]	Fiat Cinq ##ue ##cento	Ό ##μ ##ιλ ##ος Fiat
[CLS] το Suzuki Jim ##ny παρά ##γεται από το [MASK] [MASK] [MASK] . [SEP]	Suzuki Jim ##ny	Suzuki
[CLS] το Nintendo DS lite παρά ##γεται από το [MASK] [MASK] . [SEP]	Nintendo DS	Nintendo
[CLS] το Porsche Pan ##amer ##a παρά ##γεται από το [MASK] . [SEP]	Porsche	Porsche
[CLS] το Pont ##iac Fire ##bird παρά ##γεται από το [MASK] [MASK] . [SEP]	Pont ##iac	Chevrolet
[CLS] το Toyota Tun ##dra παρά ##γεται από το [MASK] . [SEP]	Toyota	Toyota
[CLS] το Je ##ep Commander παρά ##γεται από το [MASK] [MASK] [MASK] . [SEP]	Je ##ep Commander	Je ##ep
[CLS] το Lancia 037 παρά ##γεται από το [MASK] [MASK] . [SEP]	Lancia Lancia	Ό ##μ ##ιλ ##ος Fiat
[CLS] το Porsche 911 παρά ##γεται από το [MASK] [MASK] . [SEP]	Porsche 911	Porsche
[CLS] το BMW E ##65 παρά ##γεται από το [MASK] . [SEP]	BMW	BMW
[CLS] το Audi A8 παρά ##γεται από το [MASK] [MASK] . [SEP]	Audi Audi	Audi
[CLS] το Toyota Echo παρά ##γεται από το [MASK] . [SEP]	Toyota	Toyota
[CLS] το Nissan 300 ##Z ##X παρά ##γεται από το [MASK] [MASK] . [SEP]	Nissan Nissan	Nissan
[CLS] το Renault 12 παρά ##γεται από το [MASK] . [SEP]	Renault	Renault
[CLS] το Toyota Ta ##coma παρά ##γεται από το [MASK] . [SEP]	Toyota	Toyota
[CLS] το Audi A1 παρά ##γεται από το [MASK] [MASK] . [SEP]	Audi Audi	Audi
[CLS] το Ferrari F1 ##2 ##ber ##line ##tta παρά ##γεται από το [MASK] [MASK] . [SEP]	Ferrari Ferrari	Ferrari
[CLS] το Ferrari 458 Italia παρά ##γεται από το [MASK] [MASK] [MASK] . [SEP]	Ferrari 458 Italia	Ferrari
[CLS] το Ferrari F ##40 παρά ##γεται από το [MASK] . [SEP]	Ferrari	Ferrari
[CLS] το Fiat 1100 παρά ##γεται από το [MASK] [MASK] . [SEP]	Fiat Fiat	Ό ##μ ##ιλ ##ος Fiat
[CLS] το Honda NS ##X παρά ##γεται από το [MASK] [MASK] [MASK] . [SEP]	Honda NS ##X	Honda
[CLS] το BMW E3 ##0 παρά ##γεται από το [MASK] [MASK] . [SEP]	BMW BMW	BMW
[CLS] το Honda Inn ##ova παρά ##γεται από το [MASK] . [SEP]	Honda	Honda
[CLS] το Chevrolet Cor ##vette C3 παρά ##γεται από το [MASK] [MASK] [MASK] [MASK] [MASK] [MASK] [MASK] [MASK] [MASK] [MASK] . [SEP]	. . ##o . . . . . . .	Chevrolet
[CLS] το Renault Twin ##go παρά ##γεται από το [MASK] [MASK] . [SEP]	Renault Renault	Renault
[CLS] το Dodge Cha ##rger παρά ##γεται από το [MASK] [MASK] . [SEP]	Dodge Chrysler	Dodge
[CLS] το Apple II παρά ##γεται από το [MASK] . [SEP]	Apple	Apple
[CLS] το Renault 25 παρά ##γεται από το [MASK] . [SEP]	Renault	Renault
[CLS] το Chevrolet Cap ##tiva παρά ##γεται από το [MASK] . [SEP]	Chevrolet	Chevrolet
[CLS] το Toyota Crown παρά ##γεται από το [MASK] . [SEP]	Toyota	Toyota
[CLS] το BMW M ##5 παρά ##γεται από το [MASK] . [SEP]	BMW	BMW
[CLS] το Toyota Aur ##is παρά ##γεται από το [MASK] [MASK] . [SEP]	Toyota Toyota	Toyota
[CLS] το Soc ##ket T παρά ##γεται από το [MASK] [MASK] [MASK] . [SEP]	Soc ##ket T	Intel Corporation
[CLS] το Boeing 777 παρά ##γεται από το [MASK] [MASK] . [SEP]	Boeing 777	Boeing
[CLS] το IBM PC παρά ##γεται από το [MASK] [MASK] . [SEP]	IBM PC	IBM
[CLS] το Windows 7 παρά ##γεται από το [MASK] . [SEP]	Microsoft	Microsoft
[CLS] το Lancia Thema παρά ##γεται από το [MASK] [MASK] . [SEP]	Lancia Lancia	Ό ##μ ##ιλ ##ος Fiat
[CLS] το Nintendo 3DS παρά ##γεται από το [MASK] [MASK] . [SEP]	Nintendo Nintendo	Nintendo
[CLS] το Honda A ##cco ##rd παρά ##γεται από το [MASK] [MASK] [MASK] [MASK] . [SEP]	Honda A ##cco ##rd	Honda
[CLS] το BMW i ##8 παρά ##γεται από το [MASK] . [SEP]	BMW	BMW
[CLS] το Porsche 996 παρά ##γεται από το [MASK] [MASK] . [SEP]	Porsche 996	Porsche
[CLS] το Atari 8 - bit υ ##πο ##λο ##γ ##ι ##στές παρά ##γεται από το [MASK] . [SEP]	Atari	ata ##ri
[CLS] το Renault 19 παρά ##γεται από το [MASK] . [SEP]	Renault	Renault
[CLS] το BMW E3 ##6 παρά ##γεται από το [MASK] [MASK] [MASK] . [SEP]	BMW E3 ##6	BMW
[CLS] το Alfa Romeo S ##Z παρά ##γεται από το [MASK] [MASK] . [SEP]	Alfa Romeo	Ό ##μ ##ιλ ##ος Fiat
[CLS] το Audi Q ##5 παρά ##γεται από το [MASK] . [SEP]	Audi	Audi
[CLS] το Lancia L ##y ##bra παρά ##γεται από το [MASK] [MASK] [MASK] [MASK] [MASK] [MASK] [MASK] [MASK] [MASK] [MASK] . [SEP]	Lancia . . . . . . . . .	Ό ##μ ##ιλ ##ος Fiat
[CLS] το Ferrari FF παρά ##γεται από το [MASK] . [SEP]	Ferrari	Ferrari
[CLS] το Fiat 124 Spider παρά ##γεται από το [MASK] [MASK] . [SEP]	Fiat Fiat	Ό ##μ ##ιλ ##ος Fiat
[CLS] το Toyota RA ##V ##4 παρά ##γεται από το [MASK] . [SEP]	Toyota	Toyota
[CLS] το Nissan Q ##ash ##qa ##i παρά ##γεται από το [MASK] [MASK] . [SEP]	Nissan Nissan	Nissan
[CLS] το Bentley Continental GT παρά ##γεται από το [MASK] . [SEP]	Bentley	Bentley
[CLS] το iPhone παρά ##γεται από το [MASK] [MASK] [MASK] [MASK] [MASK] [MASK] [MASK] [MASK] . [SEP]	Nokia . . . . . . .	Apple
[CLS] το Intel 800 ##8 παρά ##γεται από το [MASK] . [SEP]	Intel	Intel Corporation
[CLS] το Audi RS ##4 παρά ##γεται από το [MASK] . [SEP]	2009	Audi
[CLS] το Audi A5 παρά ##γεται από το [MASK] [MASK] . [SEP]	Audi Audi	Audi
[CLS] το Dai ##hat ##su Ter ##ios παρά ##γεται από το [MASK] [MASK] [MASK] [MASK] [MASK] . [SEP]	Dai ##hat ##su Ter ##ios	Toyota
[CLS] το Toyota Land Cruise ##r παρά ##γεται από το [MASK] . [SEP]	Toyota	Toyota
[CLS] το Toyota Cam ##ry παρά ##γεται από το [MASK] . [SEP]	Toyota	Toyota
[CLS] το Airbus A3 ##80 παρά ##γεται από το [MASK] [MASK] [MASK] [MASK] [MASK] [MASK] [MASK] [MASK] [MASK] [MASK] . [SEP]	. . . . . . . . . .	Airbus
[CLS] το Honda Super Cu ##b παρά ##γεται από το [MASK] [MASK] . [SEP]	Honda Honda	Honda
[CLS] το Je ##ep Grand Cherokee παρά ##γεται από το [MASK] [MASK] [MASK] [MASK] [MASK] [MASK] [MASK] [MASK] [MASK] [MASK] . [SEP]	. . . . . . . . . .	Chrysler
[CLS] το Cadillac Bro ##ugh ##am παρά ##γεται από το [MASK] . [SEP]	Cadillac	Cadillac
[CLS] το Porsche 959 παρά ##γεται από το [MASK] . [SEP]	Porsche	Porsche
[CLS] το i ##phone 4 ##s παρά ##γεται από το [MASK] [MASK] [MASK] [MASK] . [SEP]	I ##phone 4 ##s	Apple
[CLS] το Volvo S ##80 παρά ##γεται από το [MASK] [MASK] [MASK] [MASK] [MASK] [MASK] [MASK] [MASK] [MASK] [MASK] . [SEP]	. . . . . . . . . .	Volvo
[CLS] το Nintendo DS παρά ##γεται από το [MASK] [MASK] . [SEP]	Nintendo Nintendo	Nintendo
[CLS] το BMW Μ ##6 παρά ##γεται από το [MASK] [MASK] . [SEP]	BMW BMW	BMW
[CLS] το Audi Q ##7 παρά ##γεται από το [MASK] . [SEP]	Audi	Audi
[CLS] το Boeing B - 17 Flying Fortress παρά ##γεται από το [MASK] [MASK] [MASK] [MASK] [MASK] [MASK] [MASK] [MASK] [MASK] [MASK] . [SEP]	. . . . . . . . . .	Boeing
[CLS] το Audi TT παρά ##γεται από το [MASK] [MASK] . [SEP]	Audi TT	Audi
[CLS] το Apple III παρά ##γεται από το [MASK] . [SEP]	Apple	Apple
[CLS] το Porsche 997 παρά ##γεται από το [MASK] . [SEP]	Porsche	Porsche
[CLS] το Toyota MR ##2 παρά ##γεται από το [MASK] . [SEP]	Toyota	Toyota
[CLS] το Apple I παρά ##γεται από το [MASK] . [SEP]	Apple	Apple
[CLS] το IP ##od Classic παρά ##γεται από το [MASK] [MASK] . [SEP]	IP ##od	Apple
[CLS] το Nissan Leaf παρά ##γεται από το [MASK] [MASK] . [SEP]	Nissan Nissan	Nissan
[CLS] το Toyota Hi ##lux παρά ##γεται από το [MASK] . [SEP]	Toyota	Toyota
[CLS] το Douglas O - 31 παρά ##γεται από το [MASK] [MASK] [MASK] [MASK] . [SEP]	Douglas O - 31	Douglas Aircraft Company
[CLS] το BMW E ##46 παρά ##γεται από το [MASK] . [SEP]	BMW	BMW
[CLS] το BMW E3 ##9 παρά ##γεται από το [MASK] [MASK] . [SEP]	BMW BMW	BMW
[CLS] το Xbox παρά ##γεται από το [MASK] . [SEP]	Xbox	Microsoft
[CLS] το BMW E3 ##2 παρά ##γεται από το [MASK] [MASK] . [SEP]	BMW BMW	BMW
[CLS] το Toyota Coro ##lla παρά ##γεται από το [MASK] . [SEP]	Toyota	Toyota
[CLS] το IP ##hone 3G ##S παρά ##γεται από το [MASK] [MASK] [MASK] [MASK] . [SEP]	IP ##hone 3G ##S	Apple
[CLS] το Ferrari FX ##X παρά ##γεται από το [MASK] . [SEP]	Ferrari	Ferrari
[CLS] το Audi V8 παρά ##γεται από το [MASK] [MASK] . [SEP]	Audi V8	Audi
[CLS] το iPod παρά ##γεται από το [MASK] [MASK] [MASK] [MASK] [MASK] [MASK] [MASK] [MASK] [MASK] . [SEP]	. . . . . . . . .	Apple
[CLS] το Audi RS ##2 παρά ##γεται από το [MASK] . [SEP]	2009	Audi
[CLS] το Renault 21 παρά ##γεται από το [MASK] . [SEP]	Renault	Renault
[CLS] το BMW E ##53 παρά ##γεται από το [MASK] . [SEP]	BMW	BMW
[CLS] το Alfa Romeo 164 παρά ##γεται από το [MASK] [MASK] . [SEP]	Alfa Romeo	Ό ##μ ##ιλ ##ος Fiat
[CLS] το Audi S ##5 παρά ##γεται από το [MASK] . [SEP]	Audi	Audi
[CLS] το Alfa Romeo 75 παρά ##γεται από το [MASK] [MASK] [MASK] . [SEP]	Alfa Romeo 75	Ό ##μ ##ιλ ##ος Fiat
[CLS] το ya ##mah ##a r ##1 παρά ##γεται από το [MASK] [MASK] [MASK] [MASK] [MASK] . [SEP]	ya ##mah ##a r ##1	Yamaha Motor Company
[CLS] το Audi 100 παρά ##γεται από το [MASK] . [SEP]	Audi	Audi
[CLS] το Audi S ##4 παρά ##γεται από το [MASK] [MASK] [MASK] [MASK] [MASK] [MASK] [MASK] [MASK] [MASK] [MASK] . [SEP]	body . . . . . . . . .	Audi
[CLS] το Alfa Romeo Br ##era παρά ##γεται από το [MASK] [MASK] . [SEP]	Alfa Romeo	Ό ##μ ##ιλ ##ος Fiat
[CLS] το BMW i ##3 παρά ##γεται από το [MASK] . [SEP]	BMW	BMW
[CLS] το Toyota GT 86 παρά ##γεται από το [MASK] . [SEP]	Toyota	Toyota
[CLS] το Chevrolet B ##laze ##r παρά ##γεται από το [MASK] [MASK] [MASK] [MASK] . [SEP]	Chevrolet B ##laze ##r	Chevrolet
[CLS] το Renault 8 παρά ##γεται από το [MASK] . [SEP]	Renault	Renault
[CLS] το Toyota Century παρά ##γεται από το [MASK] . [SEP]	Toyota	Toyota
[CLS] το Nintendo Entertainment System παρά ##γεται από το [MASK] . [SEP]	Nintendo	Nintendo
[CLS] το Bentley Continental Flying Spur παρά ##γεται από το [MASK] . [SEP]	Bentley	Bentley
[CLS] το Dodge Challenger παρά ##γεται από το [MASK] [MASK] . [SEP]	Dodge Dodge	Dodge
[CLS] το Inf ##ini ##ti Q ##50 παρά ##γεται από το [MASK] [MASK] [MASK] . [SEP]	Inf ##ini ##ti	Nissan
[CLS] το Toyota So ##are ##r παρά ##γεται από το [MASK] . [SEP]	Toyota	Toyota
[CLS] το Honda Pre ##lude παρά ##γεται από το [MASK] . [SEP]	Honda	Honda
[CLS] το Ferrari 575 ##M Mara ##nell ##o παρά ##γεται από το [MASK] [MASK] [MASK] [MASK] [MASK] [MASK] . [SEP]	Ferrari . ##M Mara ##nell ##o	Ferrari
[CLS] το Nissan 370 ##Z παρά ##γεται από το [MASK] [MASK] . [SEP]	Nissan Nissan	Nissan
[CLS] το Chevrolet Cam ##aro 5 ##ης γ ##εν ##ιάς παρά ##γεται από το [MASK] [MASK] [MASK] . [SEP]	Chevrolet Cam ##aro	Chevrolet
[CLS] το Porsche Ca ##yen ##ne παρά ##γεται από το [MASK] . [SEP]	Porsche	Porsche
[CLS] το Toyota Cel ##ica παρά ##γεται από το [MASK] . [SEP]	Toyota	Toyota
[CLS] το Alfa Romeo 155 παρά ##γεται από το [MASK] [MASK] [MASK] . [SEP]	Alfa Romeo 155	Ό ##μ ##ιλ ##ος Fiat
[CLS] το Fiat 128 παρά ##γεται από το [MASK] [MASK] . [SEP]	Fiat 128	Ό ##μ ##ιλ ##ος Fiat
[CLS] το Nissan Sky ##line παρά ##γεται από το [MASK] [MASK] . [SEP]	Nissan Nissan	Nissan
[CLS] το IP ##ad παρά ##γεται από το [MASK] [MASK] . [SEP]	IP ##ad	Apple
[CLS] το Nissan Ju ##ke παρά ##γεται από το [MASK] [MASK] . [SEP]	Nissan Nissan	Nissan
[CLS] το Nissan N ##V ##200 παρά ##γεται από το [MASK] [MASK] . [SEP]	Nissan Nissan	Nissan
[CLS] το Nokia N ##80 παρά ##γεται από το [MASK] . [SEP]	Nokia	Nokia
[CLS] το Honda Racing Corporation παρά ##γεται από το [MASK] [MASK] [MASK] [MASK] [MASK] [MASK] [MASK] [MASK] [MASK] . [SEP]	Honda . . . . . . . .	Honda
[CLS] το Toyota Pri ##us παρά ##γεται από το [MASK] . [SEP]	Toyota	Toyota
[CLS] το Toyota Ay ##go παρά ##γεται από το [MASK] [MASK] . [SEP]	Toyota Toyota	Toyota
[CLS] το Airbus A3 ##00 παρά ##γεται από το [MASK] [MASK] [MASK] [MASK] [MASK] [MASK] [MASK] [MASK] [MASK] [MASK] . [SEP]	. . . . . . . . . .	Airbus
[CLS] το Porsche 918 παρά ##γεται από το [MASK] [MASK] . [SEP]	Porsche Porsche	Porsche
[CLS] το Audi Q ##3 παρά ##γεται από το [MASK] . [SEP]	Audi	Audi
[CLS] το BMW M3 παρά ##γεται από το [MASK] [MASK] . [SEP]	BMW M3	BMW
[CLS] το Ferrari La ##F ##erra ##ri παρά ##γεται από το [MASK] [MASK] [MASK] [MASK] [MASK] . [SEP]	Ferrari Ferrari ##F . ##ri	Ferrari
[CLS] το Toyota Mega Cruise ##r παρά ##γεται από το [MASK] . [SEP]	Toyota	Toyota
[CLS] το Dacia Sander ##o παρά ##γεται από το [MASK] . [SEP]	Dacia	Renault
[CLS] το BMW E ##90 παρά ##γεται από το [MASK] . [SEP]	BMW	BMW
[CLS] το Nissan Na ##vara παρά ##γεται από το [MASK] [MASK] . [SEP]	Nissan Nissan	Nissan
[CLS] το Suzuki Hay ##abu ##sa παρά ##γεται από το [MASK] . [SEP]	Suzuki	Suzuki
[CLS] το Dacia Dust ##er παρά ##γεται από το [MASK] . [SEP]	Dacia	Renault
[CLS] το Volvo 850 παρά ##γεται από το [MASK] [MASK] . [SEP]	Volvo Volvo	Volvo
[CLS] το Fiat 127 παρά ##γεται από το [MASK] [MASK] . [SEP]	Fiat Fiat	Ό ##μ ##ιλ ##ος Fiat
[CLS] το Renault Wind παρά ##γεται από το [MASK] . [SEP]	Renault	Renault
[CLS] το Toyota Avalon παρά ##γεται από το [MASK] . [SEP]	Toyota	Toyota
[CLS] το Fiat 124 παρά ##γεται από το [MASK] [MASK] . [SEP]	Fiat 124	Ό ##μ ##ιλ ##ος Fiat
[CLS] το Fiat 500 ( 2007 ) παρά ##γεται από το [MASK] . [SEP]	Fiat	Ό ##μ ##ιλ ##ος Fiat
[CLS] το BMW Is ##etta παρά ##γεται από το [MASK] . [SEP]	BMW	BMW
[CLS] το Toyota Star ##let παρά ##γεται από το [MASK] . [SEP]	Toyota	Toyota
[CLS] το Audi quattro παρά ##γεται από το [MASK] [MASK] . [SEP]	Audi Audi	Audi
[CLS] το Game Boy Advance παρά ##γεται από το [MASK] [MASK] [MASK] [MASK] [MASK] [MASK] [MASK] [MASK] [MASK] [MASK] . [SEP]	. . . . . . . . . .	Nintendo
[CLS] το Audi R ##8 παρά ##γεται από το [MASK] . [SEP]	Audi	Audi
[CLS] το Dodge Durango παρά ##γεται από το [MASK] [MASK] . [SEP]	Dodge Durango	Dodge
[CLS] το Chevrolet Trail ##B ##laze ##r παρά ##γεται από το [MASK] . [SEP]	Chevrolet	Chevrolet
[CLS] το Ferrari 612 Sc ##ag ##liet ##ti παρά ##γεται από το [MASK] [MASK] . [SEP]	Ferrari Ferrari	Ferrari
[CLS] το Game Gear παρά ##γεται από το [MASK] [MASK] . [SEP]	Game Gear	Sega
[CLS] το Airbus A3 ##20 παρά ##γεται από το [MASK] [MASK] [MASK] [MASK] [MASK] [MASK] [MASK] [MASK] [MASK] [MASK] . [SEP]	. . . . . . . . . .	Airbus
[CLS] το Lex ##us IS παρά ##γεται από το [MASK] [MASK] [MASK] . [SEP]	Lex ##us IS	Toyota
[CLS] το Chevrolet Cor ##vette C4 παρά ##γεται από το [MASK] [MASK] [MASK] [MASK] [MASK] [MASK] [MASK] [MASK] [MASK] [MASK] . [SEP]	. . ##o . . . . . . .	Chevrolet
[CLS] το Chevrolet Cor ##vette C ##7 παρά ##γεται από το [MASK] [MASK] [MASK] [MASK] [MASK] [MASK] [MASK] [MASK] [MASK] [MASK] . [SEP]	. . ##o . . . . . . .	Chevrolet
[CLS] το Chevrolet Cap ##rice παρά ##γεται από το [MASK] [MASK] . [SEP]	Chevrolet Motors	Chevrolet
[CLS] το Cadillac Es ##cala ##de παρά ##γεται από το [MASK] [MASK] . [SEP]	Cadillac Cadillac	Cadillac
[CLS] το BMW E3 ##8 παρά ##γεται από το [MASK] [MASK] . [SEP]	BMW BMW	BMW
[CLS] το Cadillac D ##TS παρά ##γεται από το [MASK] [MASK] . [SEP]	Cadillac Cadillac	Cadillac
[CLS] το Windows Vista παρά ##γεται από το [MASK] [MASK] . [SEP]	Windows Vista	Microsoft
[CLS] το Dodge Ram παρά ##γεται από το [MASK] [MASK] . [SEP]	Dodge Dodge	Dodge
[CLS] το Ά ##γ ##γε ##λος παρά ##γεται από το [MASK] [MASK] [MASK] [MASK] [MASK] [MASK] [MASK] [MASK] [MASK] [MASK] . [SEP]	. . . . . . . . . .	θ ##ε ##ό
[CLS] το Super Nintendo Entertainment System παρά ##γεται από το [MASK] [MASK] . [SEP]	Nintendo Nintendo	Nintendo
[CLS] το Renault Cl ##io παρά ##γεται από το [MASK] [MASK] . [SEP]	Renault Renault	Renault
[CLS] το Chevrolet Cam ##aro 1 ##ης γ ##εν ##ιάς παρά ##γεται από το [MASK] [MASK] [MASK] . [SEP]	Chevrolet Cam ##aro	Chevrolet
[CLS] το Porsche 993 παρά ##γεται από το [MASK] [MASK] . [SEP]	Porsche 993	Porsche
[CLS] το Ferrari F ##35 ##5 παρά ##γεται από το [MASK] . [SEP]	Ferrari	Ferrari
[CLS] το Peugeot 107 παρά ##γεται από το [MASK] [MASK] . [SEP]	Peugeot Peugeot	Toyota
[CLS] το BMW E2 ##3 παρά ##γεται από το [MASK] [MASK] [MASK] . [SEP]	BMW E2 ##3	BMW
[CLS] το Ferrari California παρά ##γεται από το [MASK] . [SEP]	Ferrari	Ferrari
[CLS] το Cadillac AT ##S παρά ##γεται από το [MASK] [MASK] [MASK] [MASK] [MASK] [MASK] [MASK] [MASK] [MASK] [MASK] . [SEP]	. . . . . . . . . .	Cadillac
[CLS] το Volvo X ##C ##90 παρά ##γεται από το [MASK] . [SEP]	Volvo	Volvo
[CLS] το Cadillac CT ##S παρά ##γεται από το [MASK] [MASK] . [SEP]	Cadillac Cadillac	Cadillac
[CLS] το Airbus A3 ##50 X ##W ##B παρά ##γεται από το [MASK] [MASK] [MASK] [MASK] [MASK] [MASK] [MASK] [MASK] [MASK] [MASK] . [SEP]	" . ##o . . . . . . .	Airbus
[CLS] το Audi A4 παρά ##γεται από το [MASK] [MASK] . [SEP]	Audi A4	Audi
[CLS] το Airbus A3 ##10 παρά ##γεται από το [MASK] [MASK] [MASK] [MASK] [MASK] [MASK] [MASK] [MASK] [MASK] [MASK] . [SEP]	. . . . . . . . . .	Airbus
[CLS] το Suzuki GS ##X - R παρά ##γεται από το [MASK] . [SEP]	Suzuki	Suzuki
[CLS] το Airbus A3 ##40 παρά ##γεται από το [MASK] . [SEP]	Airbus	Airbus
[CLS] το Nintendo 2D ##S παρά ##γεται από το [MASK] . [SEP]	Nintendo	Nintendo
[CLS] το Nissan Primera παρά ##γεται από το [MASK] [MASK] . [SEP]	Nissan Nissan	Nissan
[CLS] το Toyota Ave ##nsis παρά ##γεται από το [MASK] . [SEP]	Toyota	Toyota
[CLS] το Chevrolet Bel Air παρά ##γεται από το [MASK] [MASK] [MASK] [MASK] [MASK] [MASK] [MASK] [MASK] [MASK] [MASK] . [SEP]	. . . . . . . . . .	Chevrolet
[CLS] το VW - Porsche 914 παρά ##γεται από το [MASK] [MASK] [MASK] [MASK] [MASK] [MASK] [MASK] [MASK] [MASK] [MASK] . [SEP]	. . . . . . . . . .	Porsche
[CLS] το Intel 808 ##5 παρά ##γεται από το [MASK] . [SEP]	Intel	Intel Corporation
[CLS] το Chevrolet Ta ##hoe παρά ##γεται από το [MASK] [MASK] [MASK] [MASK] [MASK] [MASK] [MASK] [MASK] [MASK] [MASK] . [SEP]	. . . . . . . . . .	Chevrolet
[CLS] το Audi A7 παρά ##γεται από το [MASK] [MASK] . [SEP]	Audi Audi	Audi
[CLS] το Lex ##us L ##FA παρά ##γεται από το [MASK] [MASK] [MASK] [MASK] . [SEP]	Lex ##us L ##FA	Toyota
[CLS] το Fiat Uno παρά ##γεται από το [MASK] [MASK] . [SEP]	Fiat Uno	Ό ##μ ##ιλ ##ος Fiat
[CLS] το Ferrari 348 παρά ##γεται από το [MASK] . [SEP]	Ferrari	Ferrari
[CLS] το Douglas DC - 3 παρά ##γεται από το [MASK] [MASK] [MASK] [MASK] . [SEP]	Douglas DC - 3	Douglas Aircraft Company
[CLS] το Alfa Romeo Mi ##T ##o παρά ##γεται από το [MASK] [MASK] . [SEP]	Alfa Romeo	Ό ##μ ##ιλ ##ος Fiat
[CLS] το Honda S2 ##000 παρά ##γεται από το [MASK] [MASK] . [SEP]	Honda Honda	Honda
[CLS] το Ferrari F ##43 ##0 παρά ##γεται από το [MASK] . [SEP]	Ferrari	Ferrari
[CLS] το Honda CB ##R ##11 ##00 ##X ##X παρά ##γεται από το [MASK] . [SEP]	Honda	Honda
[CLS] το Cadillac X ##TS παρά ##γεται από το [MASK] [MASK] . [SEP]	Cadillac Cadillac	Cadillac
[CLS] το Nintendo Wii U παρά ##γεται από το [MASK] [MASK] . [SEP]	Nintendo Nintendo	Nintendo
[CLS] το Mini Hatch παρά ##γεται από το [MASK] [MASK] . [SEP]	Mini Hatch	BMW
[CLS] το Chevrolet Silver ##ado παρά ##γεται από το [MASK] [MASK] . [SEP]	Chevrolet Motors	Chevrolet
[CLS] το Cadillac XL ##R παρά ##γεται από το [MASK] [MASK] . [SEP]	Cadillac Cadillac	Cadillac
[CLS] το Porsche Carrera GT παρά ##γεται από το [MASK] [MASK] [MASK] [MASK] [MASK] [MASK] [MASK] [MASK] [MASK] [MASK] . [SEP]	το . . . . . . . . .	Porsche
[CLS] το Chevrolet Im ##pala παρά ##γεται από το [MASK] [MASK] [MASK] [MASK] [MASK] [MASK] [MASK] [MASK] [MASK] . [SEP]	. . . . . . . . .	Chevrolet
[CLS] το Chevrolet SSR παρά ##γεται από το [MASK] [MASK] . [SEP]	Chevrolet Motors	Chevrolet
[CLS] το Dodge Vi ##per παρά ##γεται από το [MASK] [MASK] . [SEP]	Dodge Chrysler	Dodge
[CLS] το Dodge Cali ##ber παρά ##γεται από το [MASK] . [SEP]	Dodge	Dodge
[CLS] το Renault Laguna παρά ##γεται από το [MASK] . [SEP]	Renault	Renault
[CLS] το Suzuki Vita ##ra παρά ##γεται από το [MASK] [MASK] [MASK] [MASK] [MASK] [MASK] [MASK] [MASK] [MASK] [MASK] . [SEP]	. . . . . . . . . .	Suzuki
[CLS] το Audi RS ##6 παρά ##γεται από το [MASK] . [SEP]	2009	Audi
[CLS] το Cadillac STS παρά ##γεται από το [MASK] [MASK] . [SEP]	Cadillac STS	Cadillac
[CLS] το Chevrolet Cor ##vette C ##6 παρά ##γεται από το [MASK] [MASK] [MASK] [MASK] [MASK] [MASK] [MASK] [MASK] [MASK] [MASK] . [SEP]	. . ##o . . . . . . .	Chevrolet
